1111111111111111111111111111
1P00000000001110C01110000001
1111111100001110C01110000001
1000000000001110C01110000001
1000000000001110C01110000001
1000000000001110001100000001
1000000000000000000000000001
1111110000000000000000000001
1000010000000000000000000001
10C0000000000000000000000001
1000010000000000000000000001
1111110000000000000000000001
1E00000000000000000000000001
1111111111111111111111111111