111111111111111111111111111111
1VIDA1000001SO0LONG10001TMHFU1
111111111111111111111111111111