111111111111111111111111111111
1VIDA1000001SO0LONG10001TMHFU1
111111111111111111111111111111
111111111111111111111111111111
1000000000001110C0111000000001
1111111100001110C0111C11111101
100000C100001110C0111111111101
1000000100W01110C0111000000001
111111000000111000111011111111
1000000000000000000000000C0C01
111111111000111111111111111111
100001000000100001001C00000001
10C00000001110000111100X000001
1000010000000000000000000C0001
11111100P001111110100000000001
1E0000000001000000100000000001
111111111111111111111111111111
